u	က
c	ခ
:	ဂ
C	ဃ
i	င
p	စ
q	ဆ
Z	ဇ
Q	ဈ
n	ည
N	ဉ
#	ဋ
X	ဌ
!	ဍ
~	ဎ
P	ဏ
w	တ
x	ထ
K	ဒ
L	ဓ
e	န
y	ပ
z	ဖ
A	ဗ
b	ဘ
r	မ
B	ယ
&	ရ
v	လ
W	ဝ
o	သ
[	ဟ
V	ဠ
t	အ
U	ဥ
]	ဩ
{	ဧ
O	ဿ
