u	က
c	ခ
*	ဂ
C	ဃ
i	င
p	စ
q	ဆ
Z	ဇ
`a	ဈ
n	ည
~u	ဉ
#	ဋ
X	ဌ
!	ဍ
`1	ဎ
P	ဏ
w	တ
x	ထ
'	ဒ
"	ဓ
e	န
y	ပ
z	ဖ
A	ဗ
b	ဘ
r	မ
,	ယ
&	ရ
v	လ
<	ဝ
o	သ
[	ဟ
V	ဠ
t	အ
O	ဥ
{	ဧ
`5	ဩ
`o	ဿ
